WE texture/west.xpm
NO texture/north.xpm
SO texture/south.xpm
EA texture/east.xpm

F 220,100,0
C 255,30,0

11111111111111
 1111000000000111111
10000N011111111
10000001
11111111