WE texture/west.xpm
NO texture/north.xpm
SO texture/south.xpm
EA texture/east.xpm

F 220,100,0
C 255,30,0

111111111
100000001
10000NN001



10000001
11111111