WE texture/west.xpm
NO texture/north.xpm
SO texture/south.xpm
EA texture/east.xpm

F 220,100,0
C 255,30,0

1111111111111111111111111
10000000000000000E0000001
1000000001110000000000001
1000000001 10000000000001
1000000001110000000000001
1000000001110000000000001
1000000000000000000000001111
 1111000000000000000000000001
 1111000000000000000000000001
1000000000000000000111001111
10000000000000000001 1001
10000000000000000001 1001
1111111111111111111111111